3,3,3,3,3,3,3,3,3,3,3,3,3,3,3,3,3,3,3,3,3,3,3,3,3,3,3,3
3,3,3,3,3,3,3,3,3,3,3,3,3,3,3,3,3,3,3,3,3,3,3,3,3,3,3,3
3,3,3,3,3,3,3,3,3,3,3,3,3,3,3,3,3,3,3,3,3,3,3,3,3,3,3,3
3,3,3,3,3,3,3,3,3,3,3,3,3,3,3,3,3,3,3,3,3,3,3,3,3,3,3,3
3,3,3,3,3,3,3,3,3,3,3,3,3,3,3,3,3,3,3,3,3,3,3,3,3,3,3,3
3,3,3,3,3,3,3,3,3,3,3,3,3,3,3,3,3,3,3,3,3,3,3,3,3,3,3,3
3,3,3,3,3,3,3,3,3,3,3,3,3,3,3,3,3,3,3,3,3,3,3,3,3,3,3,3
3,3,3,3,3,3,3,3,3,3,3,3,3,3,3,3,3,3,3,3,3,3,3,3,3,3,3,3
3,3,3,3,3,3,3,3,3,3,4,3,3,3,3,3,3,4,3,3,3,3,3,3,3,3,3,3
3,3,3,3,3,3,3,3,3,3,3,3,3,3,3,3,3,3,3,3,3,3,3,3,3,3,3,3
3,3,3,3,3,3,3,3,3,3,3,3,3,3,3,3,3,3,3,3,3,3,3,3,3,3,3,3
9,9,9,9,7,3,3,3,3,3,4,3,3,3,3,3,3,4,3,3,3,3,3,3,3,3,3,3
2,3,3,3,10,3,3,3,3,3,3,4,3,3,3,3,3,3,3,3,3,3,3,3,3,3,3,3
2,3,3,3,10,3,3,4,4,4,3,3,3,3,3,3,3,3,3,3,3,3,3,3,3,3,3,3
1,1,8,1,3,3,3,3,3,3,1,1,1,1,1,3,1,1,3,1,1,1,1,1,1,1,1,1
2,2,11,2,3,3,3,3,3,3,2,2,2,2,2,3,2,2,2,2,2,2,2,2,2,2,2,2
2,2,2,2,3,3,3,3,3,3,2,2,2,2,2,3,2,2,2,2,2,2,2,2,2,2,2,2
2,2,2,2,3,3,3,3,3,3,2,2,2,2,2,3,2,2,2,2,2,2,2,2,2,2,2,2
2,2,2,2,3,3,3,3,3,3,2,2,2,2,2,3,2,2,2,2,2,2,2,2,2,2,2,2
2,2,2,2,3,3,3,3,3,3,2,2,2,2,2,3,2,2,2,2,2,2,2,2,2,2,2,2
2,2,2,2,3,3,3,3,3,3,2,2,2,2,2,3,2,2,2,2,2,2,2,2,2,2,2,2
2,2,2,2,3,3,3,3,3,3,2,2,2,2,2,3,2,2,2,2,2,2,2,2,2,2,2,2
2,2,2,2,3,3,3,3,3,3,2,2,2,2,2,3,2,2,2,2,2,2,2,2,2,2,2,2
2,2,2,2,3,3,3,3,3,3,2,2,2,2,2,3,2,2,2,2,2,2,2,2,2,2,2,2
2,2,2,2,3,3,3,3,3,3,2,2,2,2,2,3,2,2,2,2,2,2,2,2,2,2,2,2
2,2,2,2,3,3,3,3,3,3,2,2,2,2,2,3,2,2,2,2,2,2,2,2,2,2,2,2
2,2,2,2,3,3,3,3,3,3,2,2,2,2,2,3,2,2,2,2,2,2,2,2,2,2,2,2
2,2,2,2,3,3,3,3,3,3,2,2,2,2,2,3,2,2,2,2,2,2,2,2,2,2,2,2
2,2,2,2,3,3,3,3,3,3,2,2,2,2,2,3,2,2,2,2,2,2,2,2,2,2,2,2
2,2,2,2,3,3,3,3,3,3,2,2,2,2,2,3,2,2,2,2,2,2,2,2,2,2,2,2
2,2,2,2,3,3,3,3,3,3,2,2,2,2,2,3,2,2,2,2,2,2,2,2,2,2,2,2
2,2,2,2,3,3,3,3,3,3,2,2,2,2,2,3,2,2,2,2,2,2,2,2,2,2,2,2
2,2,2,2,3,3,3,3,3,3,2,2,2,2,2,3,2,2,2,2,2,2,2,2,2,2,2,2
2,2,2,2,3,3,3,3,3,3,2,2,2,2,2,3,2,2,2,2,2,2,2,2,2,2,2,2
2,2,2,2,3,3,3,3,3,3,2,2,2,2,2,3,2,2,2,2,2,2,2,2,2,2,2,2
2,2,2,2,3,3,3,3,3,3,2,2,2,2,2,3,2,2,2,2,2,2,2,2,2,2,2,2
2,2,2,2,3,3,3,3,3,3,2,2,2,2,2,3,2,2,2,2,2,2,2,2,2,2,2,2
2,2,2,2,3,3,3,3,3,3,2,2,2,2,2,3,2,2,2,2,2,2,2,2,2,2,2,2
2,2,2,2,3,3,3,3,3,3,2,2,2,2,2,3,2,2,2,2,2,2,2,2,2,2,2,2
2,2,2,2,3,3,3,3,3,3,2,2,2,2,2,3,2,2,2,2,2,2,2,2,2,2,2,2
2,2,2,2,3,3,3,3,3,3,2,2,2,2,2,3,2,2,2,2,2,2,2,2,2,2,2,2
2,2,2,2,3,3,3,3,3,3,2,2,2,2,2,3,2,2,2,2,2,2,2,2,2,2,2,2
2,2,2,2,3,3,3,3,3,3,2,2,2,2,2,3,2,2,2,2,2,2,2,2,2,2,2,2
2,2,2,2,3,3,3,3,3,3,2,2,2,2,2,3,2,2,2,2,2,2,2,2,2,2,2,2
2,2,2,2,3,3,3,3,3,3,2,2,2,2,2,3,2,2,2,2,2,2,2,2,2,2,2,2
2,2,2,2,3,3,3,3,3,3,2,2,2,2,2,3,2,2,2,2,2,2,2,2,2,2,2,2
2,2,2,2,3,3,3,3,3,3,2,2,2,2,2,3,2,2,2,2,2,2,2,2,2,2,2,2
2,2,2,2,3,3,3,3,3,3,2,2,2,2,2,3,2,2,2,2,2,2,2,2,2,2,2,2
2,2,2,2,3,3,3,3,3,3,2,2,2,2,2,3,2,2,2,2,2,2,2,2,2,2,2,2
2,2,2,2,3,3,3,3,3,3,2,2,2,2,2,3,2,2,2,2,2,2,2,2,2,2,2,2
2,2,2,2,3,3,3,3,3,3,2,2,2,2,2,3,2,2,2,2,2,2,2,2,2,2,2,2
2,2,2,2,3,3,3,3,3,3,2,2,2,2,2,3,2,2,2,2,2,2,2,2,2,2,2,2
2,2,2,2,3,3,3,3,3,3,2,2,2,2,2,3,2,2,2,2,2,2,2,2,2,2,2,2
2,2,2,2,3,3,3,3,3,3,2,2,2,2,2,3,2,2,2,2,2,2,2,2,2,2,2,2
2,2,2,2,3,3,3,3,3,3,2,2,2,2,2,3,2,2,2,2,2,2,2,2,2,2,2,2
2,2,2,2,3,3,3,3,3,3,2,2,2,2,2,3,2,2,2,2,2,2,2,2,2,2,2,2
2,2,2,2,3,3,3,3,3,3,2,2,2,2,2,3,2,2,2,2,2,2,2,2,2,2,2,2
2,2,2,2,3,3,3,3,3,3,2,2,2,2,2,3,2,2,2,2,2,2,2,2,2,2,2,2
2,2,2,2,3,3,3,3,3,3,2,2,2,2,2,3,2,2,2,2,2,2,2,2,2,2,2,2
2,2,2,2,3,3,3,3,3,3,2,2,2,2,2,3,2,2,2,2,2,2,2,2,2,2,2,2
2,2,2,2,3,3,3,3,3,3,2,2,2,2,2,3,2,2,2,2,2,2,2,2,2,2,2,2
2,2,2,2,3,3,3,3,3,3,2,2,2,2,2,3,2,2,2,2,2,2,2,2,2,2,2,2
2,2,2,2,3,3,3,3,3,3,2,2,2,2,2,3,2,2,2,2,2,2,2,2,2,2,2,2
2,2,2,2,3,3,3,3,3,3,2,2,2,2,2,3,2,2,2,2,2,2,2,2,2,2,2,2
2,2,2,2,3,3,3,3,3,3,2,2,2,2,2,3,2,2,2,2,2,2,2,2,2,2,2,2
2,2,2,2,3,3,3,3,3,3,2,2,2,2,2,3,2,2,2,2,2,2,2,2,2,2,2,2
2,2,2,2,3,3,3,3,3,3,2,2,2,2,2,3,2,2,2,2,2,2,2,2,2,2,2,2
2,2,2,2,3,3,3,3,3,3,2,2,2,2,2,3,2,2,2,2,2,2,2,2,2,2,2,2
2,2,2,2,3,3,3,3,3,3,2,2,2,2,2,3,2,2,2,2,2,2,2,2,2,2,2,2
2,2,2,2,3,3,3,3,3,3,2,2,2,2,2,3,2,2,2,2,2,2,2,2,2,2,2,2
2,2,2,2,3,3,3,3,3,3,2,2,2,2,2,3,2,2,2,2,2,2,2,2,2,2,2,2
2,2,2,2,3,3,3,3,3,3,2,2,2,2,2,3,2,2,2,2,2,2,2,2,2,2,2,2
2,2,2,2,3,3,3,3,3,3,2,2,2,2,2,3,2,2,2,2,2,2,2,2,2,2,2,2
2,2,2,2,3,3,3,3,3,3,2,2,2,2,2,3,2,2,2,2,2,2,2,2,2,2,2,2
2,2,2,2,3,3,3,3,3,3,2,2,2,2,2,3,2,2,2,2,2,2,2,2,2,2,2,2
2,2,2,2,3,3,3,3,3,3,2,2,2,2,2,3,2,2,2,2,2,2,2,2,2,2,2,2
2,2,2,2,3,3,3,3,3,3,2,2,2,2,2,3,2,2,2,2,2,2,2,2,2,2,2,2
2,2,2,2,3,3,3,3,3,3,2,2,2,2,2,3,2,2,2,2,2,2,2,2,2,2,2,2
2,2,2,2,3,3,3,3,3,3,2,2,2,2,2,3,2,2,2,2,2,2,2,2,2,2,2,2
2,2,2,2,3,3,3,3,3,3,2,2,2,2,2,3,2,2,2,2,2,2,2,2,2,2,2,2
2,2,2,2,3,3,3,3,3,3,2,2,2,2,2,3,2,2,2,2,2,2,2,2,2,2,2,2
2,2,2,2,3,3,3,3,3,3,2,2,2,2,2,3,2,2,2,2,2,2,2,2,2,2,2,2
2,2,2,2,2,2,2,2,2,2,2,2,2,2,2,2,2,2,2,2,2,2,2,2,2,2,2,2
2,2,2,2,2,2,2,2,2,2,2,2,2,2,2,2,2,2,2,2,2,2,2,2,2,2,2,2
2,2,2,2,2,2,2,2,2,2,2,2,2,2,2,2,2,2,2,2,2,2,2,2,2,2,2,2
2,2,2,2,2,2,2,2,2,2,2,2,2,2,2,2,2,2,2,2,2,2,2,2,2,2,2,2
2,2,2,2,2,2,2,2,2,2,2,2,2,2,2,2,2,2,2,2,2,2,2,2,2,2,2,2
2,2,2,2,2,2,2,2,2,2,2,2,2,2,2,2,2,2,2,2,2,2,2,2,2,2,2,2
mapchip,Res/data/mapchipdata/
